"filename", "language", "toml", "Python", "Markdown", "comment", "blank", "total"
"/home/michal/Documents/Skola/bakalarka/RRT-RL-2D/README.md", "Markdown", 0, 0, 2, 0, 1, 3
"/home/michal/Documents/Skola/bakalarka/RRT-RL-2D/pyproject.toml", "toml", 3, 0, 0, 0, 1, 4
"/home/michal/Documents/Skola/bakalarka/RRT-RL-2D/rrt_rl_2D/MPI/MPI.py", "Python", 0, 7, 0, 0, 3, 10
"/home/michal/Documents/Skola/bakalarka/RRT-RL-2D/rrt_rl_2D/__init__.py", "Python", 0, 9, 0, 0, 1, 10
"/home/michal/Documents/Skola/bakalarka/RRT-RL-2D/rrt_rl_2D/analytics/analytics_formatter.py", "Python", 0, 0, 0, 0, 1, 1
"/home/michal/Documents/Skola/bakalarka/RRT-RL-2D/rrt_rl_2D/assets/__init__.py", "Python", 0, 7, 0, 0, 2, 9
"/home/michal/Documents/Skola/bakalarka/RRT-RL-2D/rrt_rl_2D/assets/boundings.py", "Python", 0, 19, 0, 0, 5, 24
"/home/michal/Documents/Skola/bakalarka/RRT-RL-2D/rrt_rl_2D/assets/cable.py", "Python", 0, 109, 0, 6, 22, 137
"/home/michal/Documents/Skola/bakalarka/RRT-RL-2D/rrt_rl_2D/assets/multibody.py", "Python", 0, 145, 0, 6, 33, 184
"/home/michal/Documents/Skola/bakalarka/RRT-RL-2D/rrt_rl_2D/assets/random_block.py", "Python", 0, 18, 0, 1, 5, 24
"/home/michal/Documents/Skola/bakalarka/RRT-RL-2D/rrt_rl_2D/assets/random_obstacle_group.py", "Python", 0, 36, 0, 0, 9, 45
"/home/michal/Documents/Skola/bakalarka/RRT-RL-2D/rrt_rl_2D/assets/rectangle.py", "Python", 0, 19, 0, 0, 5, 24
"/home/michal/Documents/Skola/bakalarka/RRT-RL-2D/rrt_rl_2D/assets/singlebody.py", "Python", 0, 146, 0, 2, 39, 187
"/home/michal/Documents/Skola/bakalarka/RRT-RL-2D/rrt_rl_2D/controllers/cable_controller.py", "Python", 0, 54, 0, 0, 13, 67
"/home/michal/Documents/Skola/bakalarka/RRT-RL-2D/rrt_rl_2D/controllers/direct_controller.py", "Python", 0, 11, 0, 0, 4, 15
"/home/michal/Documents/Skola/bakalarka/RRT-RL-2D/rrt_rl_2D/controllers/env_controller.py", "Python", 0, 72, 0, 0, 19, 91
"/home/michal/Documents/Skola/bakalarka/RRT-RL-2D/rrt_rl_2D/controllers/rect_controller.py", "Python", 0, 29, 0, 0, 7, 36
"/home/michal/Documents/Skola/bakalarka/RRT-RL-2D/rrt_rl_2D/envs/cable_radius.py", "Python", 0, 104, 0, 0, 32, 136
"/home/michal/Documents/Skola/bakalarka/RRT-RL-2D/rrt_rl_2D/envs/rect.py", "Python", 0, 86, 0, 0, 26, 112
"/home/michal/Documents/Skola/bakalarka/RRT-RL-2D/rrt_rl_2D/envs/rrt_env.py", "Python", 0, 133, 0, 2, 36, 171
"/home/michal/Documents/Skola/bakalarka/RRT-RL-2D/rrt_rl_2D/export/vel_path_replayer.py", "Python", 0, 37, 0, 3, 10, 50
"/home/michal/Documents/Skola/bakalarka/RRT-RL-2D/rrt_rl_2D/import/policy_loader.py", "Python", 0, 5, 0, 0, 1, 6
"/home/michal/Documents/Skola/bakalarka/RRT-RL-2D/rrt_rl_2D/manual_models/__init__.py", "Python", 0, 2, 0, 0, 2, 4
"/home/michal/Documents/Skola/bakalarka/RRT-RL-2D/rrt_rl_2D/manual_models/base_model.py", "Python", 0, 7, 0, 0, 5, 12
"/home/michal/Documents/Skola/bakalarka/RRT-RL-2D/rrt_rl_2D/maps/__init__.py", "Python", 0, 6, 0, 0, 2, 8
"/home/michal/Documents/Skola/bakalarka/RRT-RL-2D/rrt_rl_2D/maps/empty.py", "Python", 0, 120, 0, 2, 32, 154
"/home/michal/Documents/Skola/bakalarka/RRT-RL-2D/rrt_rl_2D/maps/non_convex.py", "Python", 0, 31, 0, 0, 9, 40
"/home/michal/Documents/Skola/bakalarka/RRT-RL-2D/rrt_rl_2D/maps/piped.py", "Python", 0, 61, 0, 0, 9, 70
"/home/michal/Documents/Skola/bakalarka/RRT-RL-2D/rrt_rl_2D/maps/stones.py", "Python", 0, 30, 0, 0, 12, 42
"/home/michal/Documents/Skola/bakalarka/RRT-RL-2D/rrt_rl_2D/node_managers/__init__.py", "Python", 0, 3, 0, 0, 2, 5
"/home/michal/Documents/Skola/bakalarka/RRT-RL-2D/rrt_rl_2D/node_managers/node_manager.py", "Python", 0, 24, 0, 0, 9, 33
"/home/michal/Documents/Skola/bakalarka/RRT-RL-2D/rrt_rl_2D/node_managers/vel_node_manager.py", "Python", 0, 19, 0, 0, 6, 25
"/home/michal/Documents/Skola/bakalarka/RRT-RL-2D/rrt_rl_2D/nodes/__init__.py", "Python", 0, 3, 0, 0, 2, 5
"/home/michal/Documents/Skola/bakalarka/RRT-RL-2D/rrt_rl_2D/nodes/goal_node.py", "Python", 0, 10, 0, 0, 4, 14
"/home/michal/Documents/Skola/bakalarka/RRT-RL-2D/rrt_rl_2D/nodes/node.py", "Python", 0, 2, 0, 0, 1, 3
"/home/michal/Documents/Skola/bakalarka/RRT-RL-2D/rrt_rl_2D/nodes/tree_node.py", "Python", 0, 20, 0, 0, 8, 28
"/home/michal/Documents/Skola/bakalarka/RRT-RL-2D/rrt_rl_2D/planners/__init__.py", "Python", 0, 4, 0, 0, 2, 6
"/home/michal/Documents/Skola/bakalarka/RRT-RL-2D/rrt_rl_2D/planners/base_planner.py", "Python", 0, 26, 0, 0, 7, 33
"/home/michal/Documents/Skola/bakalarka/RRT-RL-2D/rrt_rl_2D/planners/learnable_planner.py", "Python", 0, 7, 0, 0, 4, 11
"/home/michal/Documents/Skola/bakalarka/RRT-RL-2D/rrt_rl_2D/planners/rl_planner.py", "Python", 0, 14, 0, 0, 5, 19
"/home/michal/Documents/Skola/bakalarka/RRT-RL-2D/rrt_rl_2D/planners/vec_env_planner.py", "Python", 0, 50, 0, 2, 10, 62
"/home/michal/Documents/Skola/bakalarka/RRT-RL-2D/rrt_rl_2D/rendering/base_renderer.py", "Python", 0, 19, 0, 0, 5, 24
"/home/michal/Documents/Skola/bakalarka/RRT-RL-2D/rrt_rl_2D/rendering/debug_renderer.py", "Python", 0, 48, 0, 0, 10, 58
"/home/michal/Documents/Skola/bakalarka/RRT-RL-2D/rrt_rl_2D/rendering/env_renderer.py", "Python", 0, 36, 0, 0, 12, 48
"/home/michal/Documents/Skola/bakalarka/RRT-RL-2D/rrt_rl_2D/rendering/null_renderer.py", "Python", 0, 11, 0, 0, 5, 16
"/home/michal/Documents/Skola/bakalarka/RRT-RL-2D/rrt_rl_2D/samplers/__init__.py", "Python", 0, 3, 0, 0, 2, 5
"/home/michal/Documents/Skola/bakalarka/RRT-RL-2D/rrt_rl_2D/samplers/base_sampler.py", "Python", 0, 8, 0, 0, 5, 13
"/home/michal/Documents/Skola/bakalarka/RRT-RL-2D/rrt_rl_2D/samplers/bezier_sampler.py", "Python", 0, 123, 0, 2, 22, 147
"/home/michal/Documents/Skola/bakalarka/RRT-RL-2D/rrt_rl_2D/samplers/ndim_sampler.py", "Python", 0, 15, 0, 0, 5, 20
"/home/michal/Documents/Skola/bakalarka/RRT-RL-2D/rrt_rl_2D/simulator/collision_data.py", "Python", 0, 12, 0, 0, 5, 17
"/home/michal/Documents/Skola/bakalarka/RRT-RL-2D/rrt_rl_2D/simulator/simulator.py", "Python", 0, 154, 0, 6, 37, 197
"/home/michal/Documents/Skola/bakalarka/RRT-RL-2D/rrt_rl_2D/simulator/standard_config.py", "Python", 0, 30, 0, 1, 5, 36
"/home/michal/Documents/Skola/bakalarka/RRT-RL-2D/rrt_rl_2D/storage_wrappers/__init__.py", "Python", 0, 2, 0, 0, 1, 3
"/home/michal/Documents/Skola/bakalarka/RRT-RL-2D/rrt_rl_2D/storage_wrappers/base_wrapper.py", "Python", 0, 24, 0, 0, 9, 33
"/home/michal/Documents/Skola/bakalarka/RRT-RL-2D/rrt_rl_2D/storage_wrappers/rect_end_wrapper.py", "Python", 0, 17, 0, 1, 4, 22
"/home/michal/Documents/Skola/bakalarka/RRT-RL-2D/rrt_rl_2D/storage_wrappers/standard_wrapper.py", "Python", 0, 54, 0, 1, 12, 67
"/home/michal/Documents/Skola/bakalarka/RRT-RL-2D/rrt_rl_2D/storages/GNAT.py", "Python", 0, 143, 0, 22, 32, 197
"/home/michal/Documents/Skola/bakalarka/RRT-RL-2D/rrt_rl_2D/storages/__init__.py", "Python", 0, 5, 0, 0, 2, 7
"/home/michal/Documents/Skola/bakalarka/RRT-RL-2D/rrt_rl_2D/storages/base_storage.py", "Python", 0, 13, 0, 0, 6, 19
"/home/michal/Documents/Skola/bakalarka/RRT-RL-2D/rrt_rl_2D/storages/brute_force.py", "Python", 0, 19, 0, 0, 6, 25
"/home/michal/Documents/Skola/bakalarka/RRT-RL-2D/rrt_rl_2D/storages/kd_tree.py", "Python", 0, 95, 0, 32, 35, 162
"/home/michal/Documents/Skola/bakalarka/RRT-RL-2D/rrt_rl_2D/utils/common_utils.py", "Python", 0, 7, 0, 0, 7, 14
"/home/michal/Documents/Skola/bakalarka/RRT-RL-2D/rrt_rl_2D/utils/save_manager.py", "Python", 0, 0, 0, 0, 1, 1
"/home/michal/Documents/Skola/bakalarka/RRT-RL-2D/rrt_rl_2D/utils/seed_manager.py", "Python", 0, 32, 0, 0, 10, 42
"/home/michal/Documents/Skola/bakalarka/RRT-RL-2D/scripts/development/rect_env.py", "Python", 0, 35, 0, 1, 20, 56
"/home/michal/Documents/Skola/bakalarka/RRT-RL-2D/scripts/development/rrt_rect.py", "Python", 0, 78, 0, 3, 32, 113
"/home/michal/Documents/Skola/bakalarka/RRT-RL-2D/scripts/development/test_env.py", "Python", 0, 33, 0, 9, 20, 62
"/home/michal/Documents/Skola/bakalarka/RRT-RL-2D/scripts/development/test_maps.py", "Python", 0, 33, 0, 2, 14, 49
"/home/michal/Documents/Skola/bakalarka/RRT-RL-2D/scripts/rrt_cable.py", "Python", 0, 80, 0, 3, 31, 114
"/home/michal/Documents/Skola/bakalarka/RRT-RL-2D/scripts/rrt_plan.py", "Python", 0, 0, 0, 0, 1, 1
"/home/michal/Documents/Skola/bakalarka/RRT-RL-2D/setup.py", "Python", 0, 19, 0, 0, 1, 20
"Total", "-", 3, 2633, 2, 107, 763, 3508